0000000000d0000000000000000000
0000000000d0000000000000000000
0000000000d0000000000000000000
0000000000d0000000000000000000
0000000000d0000000000000000000
0000000000d0000000000000000000
0000000000d0000000000000000000
0000000000dd0d0d00000000000000
0000000000dd0d0d00000000000000
0000000000d00d0d00000000000000
00dxd0x000d0dd0d00000000000000
000x00x000d0dd0d00000000000000
00dxd0x000d00d0d00000000000000
000x00x000dd0d0d000000000000++
00dxd0x---dd0d0d000000000000+f
000x00x000d00d0d00000000000000
/0dxd0x000d0dd0d0x0/0000000000
000x00x00000xd0d00000000000000
00dxd*x0000000000000x000000000
dddddddddddddddddddd0000000000
