xxxx0xxxx0dddddddddddddddddddd
x00x0x00x0d0000000000x0000000d
xxxx0xxxx0d00000000000x000000d
000x0000x0d000000000000x00000d
xxxx0xxxx0d0000000000000x0000d
0000000000d00000000000000x000d
0000000000d000000000x00000x00d
0000000000dd0d0dbbbb0x00000x0d
0000000000dd0d0d000000xx----xd
0000000000d00d0d00000000x000/d
00dxd0x000d0dd0d00000000x0000d
000x00x000d0dd0d000000000x000d
00dxd0x000d00d0d000000000x000d
000x00x000dd0d0d000000000x0++d
00dxd0x+++dd0d0d000000000xb+fd
000x00x000d00d0d00000000000ddd
/0dxd0x000d0dd0d0x0/000000000d
000x00x00000xd0d0000000000000d
00dxd*x0000000000000xxxxxxxxxd
dddddddddddddddddddd0000000000
