00000000000000000000000000000d
00000000000000000000000000000d
00000000000000000000000000000d
00/00000000000000000000000000d
00000000000000000000000000000d
00000000000000000000000000000d
00000000000000000000000000000d
00d0000--------------00000000d
00000000000000000000000bbbbb0d
0000d000000000000000000x000x0d
00000000000000000000000x000x0d
00000000000000000000000x000x0d
00d00000000000000000000d0f0d0d
00000000000000000000000ddddd0d
0000d000000000000000000000000d
00000000000000000000000000000d
00000000000000000000000000000d
00d00000000000000000000000000d
00000000000000000000000000000d
dddddd00000000000000000ddddddd