000000000000000000000000000000
000000000000000000000000000000
000000000000000000000000000000
00/000000000000000000000000000
000000000000000000000000000000
000000000000000000000000000000
000000000000000000000000000000
00d0000--------------000000000
00000000000000000000000bbbbb00
0000d000000000000000000x000x00
00000000000000000000000x000x00
00000000000000000000000x000x00
00d00000000000000000000d0f0d00
00000000000000000000000ddddd00
0000d0000000000000000000000000
000000000000000000000000000000
000000000000000000000000000000
00d000000000000000000000000000
000000000000000000000000000000
dddddd000000000000000000000000