000000000000000000000000000000
000000000000000000000000000000
000000000000000000000000000000
000000/000000/0000000/00000000
000000000000000000000000000000
000000000000000000000000000000
000000000000000000000000000000
000000000000000000000000000000
000+000000dd00000dd00000000000
000000000000000000000000000000
000000000000000000000000000000
000000000000000000000000000000
00+000000000000000000000000000
00000000000000000000000000d000
00000000000000000000000000d000
0000000000000000000000000ddd00
000+00000000000000000000++-++0
000000000000000000000000b---b0
0*000000000000000000000+b-f-b+
dddddd00000000000000000ddddddd