0000000000d0000000000000000000
0000000000d0000000000000000000
0000000000d0000000000000000000
0000000000d0000000000000000000
0000000000d0000000000000000000
0000000000d0000000000000000000
0000000000d0000000000000000000
0000/00000d00d0d00000000000000
0000000000d00d0d00000000000000
0000000000d00d0d00000000000000
00dxd0x000d00d0d00000000000000
000x00x000d00d0d00000000000000
00dxd-x000d00d0d00000000000000
000x00x000d00d0d00000000000000
00dxd-x000d00d0d0000000000000f
000x00x000d00d0d00000000000000
00dxd0x000d0xd0d00000000000000
000x00x000000d0d00000000000000
00dxd*x0000000000000x000000000
0ddddddddddddddddddd0000000000
