00000000000000000000000000000d
00000000000000000000000000000d
00000000000000d00000000000000d
00000000000000000000000000000d
00000000000000000000000xxbbbbd
000000000000000000000xx00d000d
0000000000000000000xx0000d000d
d0000000000000000dx000000df00d
d000000000000000000000000ddddd
d0000000ddd00ddd00000000000000
d00000000000000000000000000000
d000000d0000000000000000000000
d000000d0000000000000000000000
d000000d0000000000000000000000
d000000d0000000000000000000000
d000000d0000000000000000000000
d000000d0000000000000000000000
d000000d0000000000000000000000
d000000d0000000000000000000000
dddddddd0000000000000000000000