00000000000000000000000000000d
00000000000000000000000000000d
00000000000000000000000000000d
00000000000000000000000000000d
00f00000000000000000000000000d
0000000000000000000000000000/d
d0000000000000000000000000000d
d0++0000++000++000dd000000000d
d0000000000000000000ddd0000ddd
d000000000000000000000d000000d
d000000000000000000000d000000d
d00000000000ddd0000d++d000000d
d0/00b00b00000d0000d00d000000d
d0000000000000d0000d00d000000d
d000000000000000000d00d000000d
d000000000000000000d00d000000d
d000000000000000000d000000000x
d000000000000000000d000000000x
d000b-b--b0-b0-bjb0d000000000x
dddd0000000000000000dddddddddd
